      1111111111
   111001111100011111
   100001000100000001
   100001111100000001
   1111N0000000000001
      11111111111111   